"filename", "language", "C++", "comment", "blank", "total"
"d:\OneDrive\School\Year 6\Farseer\src\rocket\components\aeroComponent.cpp", "C++", 268, 27, 35, 330
"d:\OneDrive\School\Year 6\Farseer\src\rocket\components\aeroComponent.hpp", "C++", 77, 29, 18, 124
"d:\OneDrive\School\Year 6\Farseer\src\rocket\components\bodyComponent.cpp", "C++", 121, 15, 16, 152
"d:\OneDrive\School\Year 6\Farseer\src\rocket\components\bodyComponent.hpp", "C++", 45, 9, 11, 65
"d:\OneDrive\School\Year 6\Farseer\src\rocket\components\bodyTube\bodyTube.cpp", "C++", 0, 0, 1, 1
"d:\OneDrive\School\Year 6\Farseer\src\rocket\components\bodyTube\bodyTube.hpp", "C++", 16, 0, 4, 20
"d:\OneDrive\School\Year 6\Farseer\src\rocket\components\component.cpp", "C++", 317, 36, 39, 392
"d:\OneDrive\School\Year 6\Farseer\src\rocket\components\component.hpp", "C++", 91, 39, 26, 156
"d:\OneDrive\School\Year 6\Farseer\src\rocket\components\externalComponent.cpp", "C++", 3, 8, 1, 12
"d:\OneDrive\School\Year 6\Farseer\src\rocket\components\externalComponent.hpp", "C++", 18, 2, 5, 25
"d:\OneDrive\School\Year 6\Farseer\src\rocket\components\internalComponent.cpp", "C++", 4, 19, 1, 24
"d:\OneDrive\School\Year 6\Farseer\src\rocket\components\internalComponent.hpp", "C++", 12, 1, 4, 17
"d:\OneDrive\School\Year 6\Farseer\src\rocket\components\rocket.cpp", "C++", 4, 0, 2, 6
"d:\OneDrive\School\Year 6\Farseer\src\rocket\components\rocket.hpp", "C++", 19, 3, 3, 25
"d:\OneDrive\School\Year 6\Farseer\src\rocket\components\stage.cpp", "C++", 0, 0, 1, 1
"d:\OneDrive\School\Year 6\Farseer\src\rocket\components\stage.hpp", "C++", 14, 0, 4, 18
"d:\OneDrive\School\Year 6\Farseer\src\rocket\misc\finish.cpp", "C++", 10, 1, 3, 14
"d:\OneDrive\School\Year 6\Farseer\src\rocket\misc\finish.hpp", "C++", 14, 4, 9, 27
"d:\OneDrive\School\Year 6\Farseer\src\rocket\misc\launchConditions.cpp", "C++", 0, 0, 1, 1
"d:\OneDrive\School\Year 6\Farseer\src\rocket\misc\launchConditions.hpp", "C++", 7, 0, 3, 10
"d:\OneDrive\School\Year 6\Farseer\src\rocket\misc\material.cpp", "C++", 13, 0, 2, 15
"d:\OneDrive\School\Year 6\Farseer\src\rocket\misc\material.hpp", "C++", 13, 2, 5, 20
"d:\OneDrive\School\Year 6\Farseer\src\rocket\misc\withOverride.cpp", "C++", 3, 0, 2, 5
"d:\OneDrive\School\Year 6\Farseer\src\rocket\misc\withOverride.hpp", "C++", 5, 29, 2, 36
"d:\OneDrive\School\Year 6\Farseer\src\rocket\shapes\aeroShape.hpp", "C++", 9, 0, 5, 14
"d:\OneDrive\School\Year 6\Farseer\src\rocket\shapes\aeroShapeInterface.hpp", "C++", 12, 1, 5, 18
"d:\OneDrive\School\Year 6\Farseer\src\rocket\shapes\axisymmetricShape.cpp", "C++", 18, 1, 3, 22
"d:\OneDrive\School\Year 6\Farseer\src\rocket\shapes\axisymmetricShape.hpp", "C++", 18, 0, 5, 23
"d:\OneDrive\School\Year 6\Farseer\src\rocket\shapes\bodyComponentShape.hpp", "C++", 11, 1, 4, 16
"d:\OneDrive\School\Year 6\Farseer\src\rocket\shapes\bodyTube\bodyTube.cpp", "C++", 18, 0, 6, 24
"d:\OneDrive\School\Year 6\Farseer\src\rocket\shapes\bodyTube\bodyTube.hpp", "C++", 20, 3, 5, 28
"d:\OneDrive\School\Year 6\Farseer\src\rocket\shapes\cylinder.cpp", "C++", 81, 5, 17, 103
"d:\OneDrive\School\Year 6\Farseer\src\rocket\shapes\cylinder.hpp", "C++", 27, 8, 7, 42
"d:\OneDrive\School\Year 6\Farseer\src\rocket\shapes\externalComponentShape.hpp", "C++", 3, 10, 0, 13
"d:\OneDrive\School\Year 6\Farseer\src\rocket\shapes\hollowShape.cpp", "C++", 34, 5, 5, 44
"d:\OneDrive\School\Year 6\Farseer\src\rocket\shapes\hollowShape.hpp", "C++", 27, 10, 5, 42
"d:\OneDrive\School\Year 6\Farseer\src\rocket\shapes\internalComponentShape.hpp", "C++", 8, 0, 4, 12
"d:\OneDrive\School\Year 6\Farseer\src\rocket\shapes\nosecone\explicitNosecone.hpp", "C++", 9, 2, 5, 16
"d:\OneDrive\School\Year 6\Farseer\src\rocket\shapes\nosecone\nosecone.hpp", "C++", 18, 7, 6, 31
"d:\OneDrive\School\Year 6\Farseer\src\rocket\shapes\nosecone\numericalNosecone.hpp", "C++", 15, 3, 4, 22
"d:\OneDrive\School\Year 6\Farseer\src\rocket\shapes\shape.cpp", "C++", 7, 1, 1, 9
"d:\OneDrive\School\Year 6\Farseer\src\rocket\shapes\shape.hpp", "C++", 12, 3, 4, 19
"d:\OneDrive\School\Year 6\Farseer\src\sim\rocketInterface.cpp", "C++", 0, 0, 1, 1
"d:\OneDrive\School\Year 6\Farseer\src\sim\rocketInterface.hpp", "C++", 21, 77, 13, 111
"d:\OneDrive\School\Year 6\Farseer\src\sim\simulation.cpp", "C++", 4, 0, 2, 6
"d:\OneDrive\School\Year 6\Farseer\src\sim\simulation.hpp", "C++", 10, 0, 3, 13
"d:\OneDrive\School\Year 6\Farseer\src\utils\nanValues.hpp", "C++", 5, 0, 2, 7
"d:\OneDrive\School\Year 6\Farseer\src\utils\overrideFlags.hpp", "C++", 17, 0, 2, 19
"d:\OneDrive\School\Year 6\Farseer\src\utils\parallelAxis.cpp", "C++", 21, 0, 1, 22
"d:\OneDrive\School\Year 6\Farseer\src\utils\parallelAxis.hpp", "C++", 7, 1, 3, 11
"Total", "-", 1506, 362, 316, 2184